{
	posX: фактическая позиция устройства по оси X в метрах,
	posY: фактическая позиция устройства по оси Y в метрах,
	posZ: фактическая позиция устройства по оси Z в метрах,
	posXf: отфильтрованная позиция устройства по оси X в метрах,
	posYf: отфильтрованная позиция устройства по оси Y в метрах,
	posZf: отфильтрованная позиция устройства по оси Z в метрах,

	rotX: фактический угол поворота устройства по оси X в градусах,
	rotY: фактический угол поворота устройства по оси Y в градусах,
	rotZ: фактический угол поворота устройства по оси Z в градусах,
	rotXf: отфильтрованный угол поворота устройства по оси X в градусах,
	rotYf: отфильтрованный угол поворота устройства по оси Y в градусах,
	rotZf: отфильтрованный угол поворота устройства по оси Z в градусах,

	speed: скорость перемещения,
	
    accX: фактическое значение акселерометра по X,
    accY: фактическое значение акселерометра по Y,
    accZ: фактическое значение акселерометра по Z,
    accXf: отфильтрованное значение акселерометра по X,
    accYf: отфильтрованное значение акселерометра по Y,
    accZf: отфильтрованное значение акселерометра по Z,

    gX: фактическое значение гироскопа по X,
    gY: фактическое значение гироскопа по Y,
    gZ: фактическое значение гироскопа по Z,
    gXf: отфильтрованное значение гироскопа по X,
    gYf: отфильтрованное значение гироскопа по Y,
    gZf: отфильтрованное значение гироскопа по Z,

    magX: фактическое значение магнитометра по X,
    magY: фактическое значение магнитометра по Y,
    magZ: фактическое значение магнитометра по Z,
    magXf: отфильтрованное значение магнитометра по X,
    magYf: отфильтрованное значение магнитометра по Y,
    magZf: отфильтрованное значение магнитометра по Z,

    alt: фактическое значение барометра,
    altf: отфильтрованное значение барометра
}
